R 1200 800
NO pics/eagle.xpm
SO pics/mountain.xpm
WE pics/brick.xpm
EA pics/metal.xpm
S pics/barrel.xpm

F  1,1,133
C  1,1,1

        1111111111111111111111111
        1000100100110000000000001
        1011000001110000002020001
        1001000000000E000020000011
111111111011000001110000200000001
1000000000110000011101111111111111
11110111111111011100011110001
1111011111111101110001 110001
11000000110101011100011110001
10002000000000000000020010001
10000000000000000001010010001
1100000111010101111101111000111
11110111 1110101 101111010001
11111111 1111111 111111111111
